#############################################################
#S  # #   #                           #   #   #     #       #
# ### # # ##### ####### # # ############# # ### ### # # ### #
#       #   #     # # # # # # # #   #             # # # #   #
######### ### # ### # # ##### # # # ### ##### ##### ##### ###
#       # #   # # # #             #     # #       #   # #   #
### # # # ##### # # ##### # ######### ### ######### # # # ###
# # # #       # #   #   # # #   # # #       #       #       #
# # # ##### ####### # ####### ### # # ########### ######### #
#   #   # # # # #   # # #         #   #   # #   # #   # #   #
# ### ### ### # ### # # # ### ### ####### # # ### # # # ### #
# # #     #   #     #   # #     #   #   #           #   #   #
### ### ### # ### ### # ##### # # # ### # # ### # ### ##### #
# # #   #   # #     # #       # # #   # # # #   #   #   # # #
# # # ### ### # # # ### ### ########### ### # ########### # #
#         # # # # #   # #     # #   # #     #             # #
### # ### # ######### # ##### # ### # ### ####### ##### #####
# # # #     #       #   #   # #         # # #   # # #   # # #
# # # ### # ##### ##### # ### ##### # ### # ### ### ### # # #
#   #   # #         #   #   #       # #   #     #   #   #   #
######### # # ### ##### ### ##### # ##### # ####### ##### ###
#   #   # # #   # #     #     #   # # #             #       #
# ##### ### # ### # # ### # # # ### # # # ### ##### ####### #
# #     #   # #     # #   # # #   #     # #   # #     # #   #
# ### ### # # ##### ####### ##### ##### ### # # ##### # ### #
#         # # # # # #     #   #   #       # #     # #       #
##### ####### # # ### # ### # # ########### ####### # # ### #
# #         #     # # # # # #     #         # #       #   # #
# ### # # ### ### # ### # # # ### ### # ### # # # ### ### # #
#     # #   # #           # #   # #   # #   #   # #     # #E#
#############################################################
