#############################################################################################################################################
#S  #   #   #               #               #       #   #     #         #   #             #   #   #   #   #         # #     # #       #     #
### ### # # # ########### ### # ##### # # ####### # # # # # # ##### # ##### ##### ### ##### ##### # ### ######### ### # ### # # ### ### # # #
#         #       #       # # # # # # # # # # #   #   #   # #   # # # # # #     #   # #     #         #   # #     #       # #     # # # # # #
# ##### ######### ### ### # # # # # ### # # # ############### ### # ### # ### ####### # # ##### ####### ### # ##### # ### # # ##### # ### ###
#   # #     #   #   # # #   # # #       # # #             #       #             #     # #   #       # #   #       # #   # # # # #     # # # #
### # ######### ### # # # ### # ### # ### # ##### ##### ### ########### ####### ##### ### ### ### ### ### ### ######### ##### # # ##### # # #
#   #     #         # #   #   # # # # #     # #     #     #     #   #   #         #   # # #     #       # # #     #           #     #       #
### ##### ##### ### ### ##### ### # ######### # # ### ##### ##### ##### ####### ##### # # # ######### # # # ### ######### ##### # ### ### ###
#     #   #       # # # #   # #       #   #   # # # #     # #     #     #   # # #   #     #     #     #     #     #   #     #   #     # #   #
### # ### ##### ### # ### # ##### # ##### # ####### # ##### ##### # ### # ### # # ##### # # ##### ### ##### # ##### ### ### ####### ### # # #
# # #     #   # #   #   # #   #   # #   # # #     # #     #       # #   # # #   #   # # #     # # #   #   #       # #   #   # #     #   # # #
# # ### ### # ##### ### # # ####### # ### # # ##### # ### # # ##### ##### # # ### # # ### # # # ### # # # ##### ### ### ##### ### ##### #####
#   # #   # # #   #       # # #     # # #   #       #   # # #       #     #   #   # #   # # # #   # #   # #     # #   #   #     #           #
# # # # # ### # # # ### ##### # ##### # ### ### ####### ### ####### ### # # # # # ### ######### ### ######### # # ### # ### ### ##### #######
# # #   # #     #   # # #         #     #     # #     #   # # #   # #   #   #   #   # # # # # #     #     #   #   #   #     #       # #   # #
# ####### ### ### ### ######### ### # ### ### # ##### ### ### # ### ### # ### ##### # # # # # # # ### ####### ### # ### ### ### ######### # #
#   # #     # #         # #         #   # # #       # #       #       # # #       # #     #     # # #   # #   #   # #   #   #   # # # #   # #
# ### ########### ### # # ##### ####### ### # ### ### # ### ### ####### ### ##### ### # ##### ##### # ### # ##### # # ##### # # # # # # ### #
#       # #     # # # # #   #     #   #       #   #     #   #         #   # #       # #                 #       #   #     # # # #   #     # #
# # ##### # ### ### ### # # ######### ### ##### # # # # # ######### ############# # # ##### ####### ##### ### # ### ### # ### ### # # ### # #
# #   #       #   #     # #           # #   #   #   # # #       #         #   # # # # #     # #       #     # #   #     # # #   # #   #     #
# # ### # ############### # # # ##### # # ##### # ### ##### ### # # ### ##### # ####### ##### # # # ####### ### ##### ### # # ##### #########
# #     # #           # # # # #     #       # # # # # #   #   # # #   #     #   #       #   # # # #   # #   #   #     # # #   # # #   #     #
# ####### ### # ##### # ####### # # # # ##### # # # ### ### ####### ##### ##### ########### # ### # ### # ######### ### # ### # # # ### #####
#       # #   #   #     # #     # # # # #     # # # # #         # #     # #       # #           # #   # #   # #       #   # #   #       #   #
# ########### # ### ### # # ####### ### ##### # # # # ### ### # # # # ######### # # # # ### # # # ##### # # # ### ### ##### ##### ### ### # #
#   # #     # # #     #   #       # #     # #   #       #   # #     #         # #     #   # # #     # #   #     # #     #       # #       # #
### # # ##### ### ### ##### # ### ##### # # ######### ####### ########### ### ############# # ##### # ### ### ### # # ### ### ####### #######
#         # # #     #     # #   #   #   #         #   #     # #   #     # # #   #   # # # # # #   # #       # #   # #   # # # #   #     #   #
######### # # ### ### ### ### ### ##### ########### ### # ##### # ### # # # ### # ### # # ### ### ######### ##### ### ### # ##### ##### # # #
#       # # #   # #   # # #   #       #   # #     # # # # #   # # # # # #     #               # #           # # # # # #       #           # #
# ##### # # ##### ### # ######### ####### # ### ##### ### ### # # # # ##### ########### # ### # # ######### # # # # # ####### ##### ### # ###
#     #           # #       # # #     #           #         #   #   # # #         # #   # #   #   #     #     #   #           # #   #   #   #
# ### ########### # ### # ### # ##### ############# ########### ### # # # # # ### # ########### ### # ##### ####### ### ### # # # # # # ### #
# #   #     #   # # #   # # #                 #   #       # # # #       # # #   #   # #     #   #   #       # #       #   # # #   # # #   # #
# # # ##### ### ### ##### # ### ### # # ### # # ### ####### # ##### ####### ### ### # # ####### ##### ####### ##### # ##### # ##### #########
# # # # #     #   #   # #   #     # # # #   # #     #           # #   #     #   #   #   # # #       # #   #     #   # #   # # # #   #   #   #
### ### # # ##### ### # ### ### # # ####### ### ######### ### ### # # ##### # ### # ### # # ### # # ##### ### # # # # ### # ### # # # ### # #
# # # #   # #   # # #     #     # #   #     # # #   #       # #     #     # # # # # #         # # #       #   # # # # #   #       #   #   # #
# ### ### ### # # # # # # # ### ### ######### # ### # ##### ### ######### # ### ### ##### ##### ### ### ### ##### ### # ### ######### # # ###
#         # # #   # # # #   # #   #                 #   #   #       # #   # # #   # # #   #   #   #   # # #     # # #   # #       #   # #   #
# # ##### # # ### # # ####### ### ### ##### ######### ######### # # # ####### ### # # # ### # # ####### # # ### ### ### # ####### ####### ###
# #   # #       # # #   # #     # # # # #       #     #     #   # #         #   #           # # #             # #   # #   # #   #     #     #
### ### ####### # # ### # ##### ### ### # # ##### ### # ######### # ##### ### ##### ########### ######### ### ##### # ##### # ##### ####### #
# # #   # #     #   # # #           # # # # #   # #   # #         # # #   #     #     #     #   # #         #   #     # #   #   # #         #
# ##### # ####### # # ######### ### # # ### # ##### ### ##### # ##### ##### ######### # ######### ### ### ########### # # ##### # ### #######
# # # #     #   # #     # #   #   #   #   #   #     #   # #   #   #   #         #   # #   # #   #     # #   #       # # # #     #     #   # #
# # # # ####### ### ### # ### ##### ##### # ####### # ### ### ####### # # ### ### # # ### # # ### # ### # ### ##### # # # ### ####### # # # #
# #     #   #     # #     #   #           #   #       #   # #     #     # #   #   #   #   #   #   # #       # #         #     #   #   # #   #
# # ### ### # ####### ### # ####### # # # # ### ### ### # # # ### # ####### ####### # ### # ### # ##### # ##### # # ######### # ####### # ###
#   # #               #   #     # # # # #       # #   # #   #   #     #       #     #         # #   #   #   #   # # #         # #     # #   #
# ### ##### ############# # ### # # # ##### ##### # ##### ######### ##### ### ### ### ### ######### ######### ##### ##### ##### ### ### ### #
# # #   #   #   # #         #   #   #   #   # #       #     # #     # #   # #       #   #   # #             # #   # #           #       #   #
# # # ### # ### # ##### ##### # # ### ##### # # ##### # ### # # ##### # ### # # ##### ####### # ### # ####### # ### ####### # ### # # ### # #
# # #     #   #     #   # #   #   #   #       #   #   #   #   #   #     #     #   #     #     # # # #           # # #       #   # # # #   # #
### ####### # # ##### ### ######### ##### ######### # # ### ### ### # ### # ### # ##### ##### # # # ### ### ##### # # # # ####### ####### ###
#   #   #   #     # #       # #   #   # # #     #   #   #     # #   #   # # # # #     #   # #     #   # #     #   #   # #     # # # # #     #
# # # # # ##### # # # ####### # ##### # # # # # ### ##### ### ##### # ##### # ####### # ### ### ##### ### ### # # # ### # # # # # # # # ### #
# #   #   #     #   #               # #     # # #     #     #     # #     #   #       #     #       # #   #   # #     # # # #         # #  E#
#############################################################################################################################################
