######################################################################
#S#       #         #                 #       #             #        #
# # ##### # ####### # ############### # ##### # ########### # ###### #
#   #   #   #       # #             #   # # #       #       # #    # #
##### # ####### ##### # ##### # ##### ### # ####### # ####### #    # #
#     #       # #   #       # #     #     #       # # #       # #### #
# ########### # # # ##### # # ##### ############# # # # #######      #
# #   #       #   #     # #   #   #   #           # # #     #   #### #
# # # # ####### ######### ##### # # # ############# # ##### # ###### #
#   # # #     #       #         #   #   #           #       #      # #
##### # # ### ####### # ######### ### # # ################# ###### # #
#     #   # #       # #   #     #     # #               #        # # #
# ######### ####### # ##### ### ####### # ############# ######## # # #
#       #         #           #         #       #            #   #  E#
######################################################################