#####################################################################################################
#S      # #     #     # # # #   #       # # # #   #                 #       # # #     # # #   #     #
####### # # ### # ##### # # ### # ### # # # # ### ######### ### ##### # ### # # # # # # # ### ##### #
#   #   #   #   # #   #           #   # #     # #     # #   #     # # # #         # # # #   # #     #
### ### ### ### # # ### ####### # ### # # ##### # ### # ####### # # ### ### ### ### ### # # # # ### #
# #       # #       #   #       #   # #   #     # #         # # #       # # #     #     # #     #   #
# # ##### ######### # ######### ##### ######### ##### # # ### # ##### ### ### ### ######### ### # # #
# # #   # #         #   #       # # #           #     # # #   #     #   # #   #       # # # # # # # #
# # ### ### # ### ##### ##### # # # # ### ##### # # ######### # # ##### # ######### ### # # # # # ###
# #         #   #   #   #   # #   #     # #       #   #       # #   #             # # # #   # # # # #
# ### ############### # ### ####### ### ##### ### ####### ### ####### ##### ####### # # ### # # # # #
# # #   #     #   # # #   #   #     # # # #   #         # #       # #     #   # #   #         # #   #
# # # ### # ### ### ### ### ### ##### ### # # # ### # ### ### ##### ##### # # # ##### # ########### #
#         #       #     # #           #   # # # #   #   # # #       #   # # #     # # # # #         #
### ### ### ### ### ##### ### # ##### ### ### ##### # # # # ### ####### # ##### ### # ### ### ##### #
#     # #     #   #     #     #   # #   # #     #   # #   #   #   # #         # #       #   #   #   #
### ### ### # # # # # # # # # ### # ##### ### ##### ### ### # ### # # ##### ######### ##### # # #####
#   #   # # # # # # # # # # # # #     #       # #   # #     # # #       # #     # # #     # # #     #
# ##### # ### ######### ##### # # ####### ### # ### # # # # ### ### ### # ####### # ##### # ##### # #
#   #       #   # # #   #   # #         # #   #     #   # # #   #   #           #   # # # #   #   # #
# # # ########### # # ##### ### ### # ### ############# ### ### # ##### # # ##### ### # # # ### #####
# # #   #     #   #       #     #   #   #   # #     #     # #       #   # #     # #   #   #   #     #
##### # ### ### ####### # ### # ####### ##### # # # ### ####### ### ######### # # # ### # # ### ### #
#     #   # # #     #   #   # # #     # # #     # # #       #   #     #   # # #     #   #     #   # #
# ##### ### # # # ##### # # ### # # # ### # ####### ### ####### ##### ### # # ##### # ##### ##### # #
#   #       # # #     # # # # #   # # #         #       #     # # # #   #   #   # #   #       #   # #
# ### # # ### # # ####### ### # # # ####### ### ### ##### ##### # # ####### # ### # #################
#   # # #       #   # # # #   # # #     # # #     #   #   # #         #   # #   # #           # #   #
### ########### ##### # # ### ########### # # # ##### # ### ### ### ##### # # ### ####### ##### # # #
#   #   #     #   # #     # # #     #   #   # # #   #     # #   # #     #             # #     #   # #
### ### # # # ### # # ### # # # # ### # ### ##### ##### # # # # # ####### ####### # ### ####### ### #
# # #   # # # #   #   # # #     # #   # #     # #     # #   # # # # #   # # #   # # #   # #   #   # #
# ### ####### # ##### # ### # ##### ########### # ##### ####### # # ### ### ### ### # ### # ####### #
# #     # # # #     #     # # #   #       #   #     # #   #                 #   #   #   #   #   #   #
# ### ### # # # ##### # ### # ### # # # ##### ### ### ######### ### ### ##### ### ### ### # # # # ###
#                   # #   # # # # # # #             #   #         #   # # #       #   #   #   # #   #
# # ### # # # ### # ##### ### # # # ##### ##### # ##### ### ##### ####### ##### ##### # # # ### # ###
# # # # # # #   # #   #       #     #   #     # # #     #   #       # # # # #   # # #   # #   #     #
# # # ### ######### # ### ### # ####### # # ### ####### ### # ### ### # # # ### # # # # ### ##### ###
# # #     #         #       #       #     #   # #           #   #           #         #   # #      E#
#####################################################################################################
